map2
3
10
10
0 0 0 0 0 0 0 0 0 0
2 1 1 7 0 0 0 0 1 2
0 1 0 0 0 0 0 0 1 0
0 7 0 0 0 0 0 0 1 0
0 0 0 0 0 0 0 0 1 0
0 0 0 0 0 0 0 0 1 0
0 0 0 0 0 0 0 0 1 0
0 0 0 0 0 0 0 7 1 0
0 0 0 0 0 7 1 1 1 0
0 0 0 0 0 0 0 0 0 0
0 0 0 0 0 0 0 0 0 0
0 0 8 20 19 18 17 7 0 0
0 8 0 0 0 0 0 0 0 0
0 6 0 0 0 0 0 7 0 0
0 5 0 0 0 0 0 13 0 0
0 4 0 0 0 0 0 14 0 0
0 3 0 0 0 0 0 15 0 0
0 7 0 0 0 0 0 16 0 0
0 7 9 10 11 12 8 8 0 0
0 0 0 0 0 0 0 0 0 0
0 0 0 0 0 0 0 0 0 0
0 0 0 0 0 0 8 1 0 0
0 0 0 0 0 0 0 1 0 0
0 0 0 0 0 0 0 1 0 0
0 0 0 0 0 0 0 8 0 0
0 0 0 0 0 0 0 0 0 0
0 8 0 0 0 0 0 0 0 0
0 1 0 0 0 0 0 0 0 0
0 1 8 0 0 0 0 0 0 0
0 0 0 0 0 0 0 0 0 0
1 2 9